{
	"moves": 5,
	"colors": [
		{
			"r": 1,
			"g": 0.92,
			"b": 0.016,
			"a": 1
		},
		{
			"r": 1,
			"g": 0,
			"b": 0,
			"a": 1
		},
		{
			"r": 0,
			"g": 1,
			"b": 0,
			"a": 1
		},
		{
			"r": 0,
			"g": 0,
			"b": 1,
			"a": 1
		},
		{
			"r": 1,
			"g": 0,
			"b": 1,
			"a": 1
		}
	],
	"grid": [
		4, 0, 1, 1, 0, 0, 0, 0, 1, 1, 0, 0,
		4, 1, 1, 0, 0, 0, 0, 0, 1, 1, 0, 0,
		4, 0, 1, 1, 0, 0, 0, 0, 1, 1, 0, 0,
		4, 1, 1, 0, 0, 0, 0, 0, 1, 1, 0, 0,
		4, 0, 1, 1, 0, 0, 0, 0, 1, 1, 0, 0,
		4, 1, 1, 0, 0, 0, 0, 0, 1, 1, 0, 0,
		4, 0, 1, 1, 0, 0, 0, 0, 1, 1, 0, 0,
		4, 1, 1, 0, 0, 0, 0, 0, 1, 1, 0, 0,
		4, 0, 1, 1, 0, 0, 0, 0, 1, 1, 0, 0,
		4, 1, 1, 0, 0, 0, 0, 0, 1, 1, 0, 0,
		4, 0, 1, 1, 0, 0, 0, 0, 1, 1, 0, 0,
		4, 1, 1, 0, 0, 0, 0, 0, 1, 1, 0, 0
	]
}